0 0 0 0 0 0 0 0 0 0 0 0 0 0 0 0 0 
0 1 1 1 1 1 1 1 1 1 1 1 1 1 1 1 0 
0 2 3 0 0 0 0 0 4 0 0 0 0 0 0 0 0 
0 0 0 0 0 0 7 0 1 0 0 7 0 0 0 0 0 
0 1 1 0 0 0 0 0 1 1 0 0 0 0 1 1 0 
0 1 5 0 0 0 0 0 1 0 0 0 0 1 4 1 0 
0 1 0 0 0 0 0 0 1 0 0 0 0 0 4 1 0 
0 1 0 0 0 1 1 1 1 1 0 1 0 0 0 1 0 
0 1 1 0 0 1 4 5 0 0 0 1 0 0 1 1 0 
0 1 0 0 0 1 1 1 6 1 1 1 0 0 0 1 0 
0 1 5 0 0 0 0 0 0 0 0 0 0 0 4 1 0 
0 1 1 1 1 1 1 1 1 1 1 1 1 1 1 1 0 
0 0 0 0 0 0 0 0 0 0 0 0 0 0 0 0 